{
"maps":{
  "og":"*********\n*    ^ E*\n*^ ^  🔴^*\n*^ ^^^^**\n*   ^ ^**\n*^^    ^*\n*S   ^ 🔵*\n*********",
	"2,2":"*********\n*    ^ E*\n*^ ^  🔴^*\n*^ ^^^^**\n*   ^ ^**\n*^^    ^*\n*S   ^ 🔵*\n*********",
	"3,2":"*********\n*    ^ E*\n*^ ^  🔴^*\n*^ ^^^^**\n*   ^ ^**\n*^^    ^*\n* S  ^ 🔵*\n*********",
	"4,2":"*********\n*    ^ E*\n*^ ^  🔴^*\n*^ ^^^^**\n*   ^ ^**\n*^^    ^*\n*  S ^ 🔵*\n*********",
	"5,2":"*********\n*    ^ E*\n*^ ^  🔴^*\n*^ ^^^^**\n*   ^ ^**\n*^^    ^*\n*   S^ 🔵*\n*********",
	"7,2":"*********\n*    ^ E*\n*^ ^  🔴^*\n*^ ^^^^**\n*   ^ ^**\n*^^    ^*\n*    ^S🔵*\n*********",
	"4,3":"*********\n*    ^ E*\n*^ ^  🔴^*\n*^ ^^^^**\n*   ^ ^**\n*^^S   ^*\n*    ^ 🔵*\n*********",
	"5,3":"*********\n*    ^ E*\n*^ ^  🔴^*\n*^ ^^^^**\n*   ^ ^**\n*^^ S  ^*\n*    ^ 🔵*\n*********",
	"6,3":"*********\n*    ^ E*\n*^ ^  🔴^*\n*^ ^^^^**\n*   ^ ^**\n*^^  S ^*\n*    ^ 🔵*\n*********",
	"7,3":"*********\n*    ^ E*\n*^ ^  🔴^*\n*^ ^^^^**\n*   ^ ^**\n*^^   S^*\n*    ^ 🔵*\n*********",
	"2,4":"*********\n*    ^ E*\n*^ ^  🔴^*\n*^ ^^^^**\n*S  ^ ^**\n*^^    ^*\n*    ^ 🔵*\n*********",
	"3,4":"*********\n*    ^ E*\n*^ ^  🔴^*\n*^ ^^^^**\n* S ^ ^**\n*^^    ^*\n*    ^ 🔵*\n*********",
	"4,4":"*********\n*    ^ E*\n*^ ^  🔴^*\n*^ ^^^^**\n*  S^ ^**\n*^^    ^*\n*    ^ 🔵*\n*********",
	"6,4":"*********\n*    ^ E*\n*^ ^  🔴^*\n*^ ^^^^**\n*   ^S^**\n*^^    ^*\n*    ^ 🔵*\n*********",
	"3,5":"*********\n*    ^ E*\n*^ ^  🔴^*\n*^S^^^^**\n*   ^ ^**\n*^^    ^*\n*    ^ 🔵*\n*********",
	"3,6":"*********\n*    ^ E*\n*^S^  🔴^*\n*^ ^^^^**\n*   ^ ^**\n*^^    ^*\n*    ^ 🔵*\n*********",
	"5,6":"*********\n*    ^ E*\n*^ ^S 🔴^*\n*^ ^^^^**\n*   ^ ^**\n*^^    ^*\n*    ^ 🔵*\n*********",
	"6,6":"*********\n*    ^ E*\n*^ ^ S🔴^*\n*^ ^^^^**\n*   ^ ^**\n*^^    ^*\n*    ^ 🔵*\n*********",
	"7,6":"*********\n*    ^ E*\n*^ ^  S^*\n*^ ^^^^**\n*   ^ ^**\n*^^    ^*\n*    ^ 🔵*\n*********",
	"2,7":"*********\n*S   ^ E*\n*^ ^  🔴^*\n*^ ^^^^**\n*   ^ ^**\n*^^    ^*\n*    ^ 🔵*\n*********",
	"3,7":"*********\n* S  ^ E*\n*^ ^  🔴^*\n*^ ^^^^**\n*   ^ ^**\n*^^    ^*\n*    ^ 🔵*\n*********",
	"4,7":"*********\n*  S ^ E*\n*^ ^  🔴^*\n*^ ^^^^**\n*   ^ ^**\n*^^    ^*\n*    ^ 🔵*\n*********",
	"5,7":"*********\n*   S^ E*\n*^ ^  🔴^*\n*^ ^^^^**\n*   ^ ^**\n*^^    ^*\n*    ^ 🔵*\n*********",
	"7,7":"*********\n*    ^SE*\n*^ ^  🔴^*\n*^ ^^^^**\n*   ^ ^**\n*^^    ^*\n*    ^ 🔵*\n*********"

   },
   "walls":[
      
   ],
   "spikes":[
		 "2,3",
		 "3,3",
		 "8,3",
		 "6,2",
		 "8,2",
		 "5,4",
		 "7,4",
		 "2,5",
		 "4,5",
		 "5,5",
		 "6,5",
		 "7,5",
		 "2,6",
		 "4,6",
		 "8,6",
		 "6,7"
	 ],
   "startPosition":{
      "x":"2",
      "y":"2"
   },
   "endPosition":{
      "x":"8",
      "y":"7"
   }
}		