{
   "maps":{
      "og":"*********\n* *     *\n*   ***S*\n**^ * ***\n*   * ***\n* ***  E*\n*  *^ ***\n**      *\n*********",
			"8,7": "*********\n* *     *\n*   ***S*\n**^ * ***\n*   * ***\n* ***  E*\n*  *^ ***\n**      *\n*********",
			"8,8": "*********\n* *    S*\n*   *** *\n**^ * ***\n*   * ***\n* ***  E*\n*  *^ ***\n**      *\n*********",
			"7,8": "*********\n* *   S *\n*   *** *\n**^ * ***\n*   * ***\n* ***  E*\n*  *^ ***\n**      *\n*********",
			"6,8": "*********\n* *  S  *\n*   *** *\n**^ * ***\n*   * ***\n* ***  E*\n*  *^ ***\n**      *\n*********",
			"5,8": "*********\n* * S   *\n*   *** *\n**^ * ***\n*   * ***\n* ***  E*\n*  *^ ***\n**      *\n*********",
			"4,8": "*********\n* *S    *\n*   *** *\n**^ * ***\n*   * ***\n* ***  E*\n*  *^ ***\n**      *\n*********",
			"2,8": "*********\n*S*     *\n*   *** *\n**^ * ***\n*   * ***\n* ***  E*\n*  *^ ***\n**      *\n*********",
			"2,7": "*********\n* *     *\n*S  *** *\n**^ * ***\n*   * ***\n* ***  E*\n*  *^ ***\n**      *\n*********",
			"3,7": "*********\n* *     *\n* S *** *\n**^ * ***\n*   * ***\n* ***  E*\n*  *^ ***\n**      *\n*********",
			"4,7": "*********\n* *     *\n*  S*** *\n**^ * ***\n*   * ***\n* ***  E*\n*  *^ ***\n**      *\n*********",
			"4,6": "*********\n* *     *\n*   *** *\n**^S* ***\n*   * ***\n* ***  E*\n*  *^ ***\n**      *\n*********",
			"6,6": "*********\n* *     *\n*   *** *\n**^ *S***\n*   * ***\n* ***  E*\n*  *^ ***\n**      *\n*********",
			"2,5": "*********\n* *     *\n*   *** *\n**^ * ***\n*S  * ***\n* ***  E*\n*  *^ ***\n**      *\n*********",
			"3,5": "*********\n* *     *\n*   *** *\n**^ * ***\n* S * ***\n* ***  E*\n*  *^ ***\n**      *\n*********",
			"4,5": "*********\n* *     *\n*   *** *\n**^ * ***\n*  S* ***\n* ***  E*\n*  *^ ***\n**      *\n*********",
			"6,5": "*********\n* *     *\n*   *** *\n**^ * ***\n*   *S***\n* ***  E*\n*  *^ ***\n**      *\n*********",
			"2,4": "*********\n* *     *\n*   *** *\n**^ * ***\n*   * ***\n*S***  E*\n*  *^ ***\n**      *\n*********",
			"6,4": "*********\n* *     *\n*   *** *\n**^ * ***\n*   * ***\n* ***S E*\n*  *^ ***\n**      *\n*********",
			"7,4": "*********\n* *     *\n*   *** *\n**^ * ***\n*   * ***\n* *** SE*\n*  *^ ***\n**      *\n*********",
			"2,3": "*********\n* *     *\n*   *** *\n**^ * ***\n*   * ***\n* ***  E*\n*S *^ ***\n**      *\n*********",
			"3,3": "*********\n* *     *\n*   *** *\n**^ * ***\n*   * ***\n* ***  E*\n* S*^ ***\n**      *\n*********",
			"6,3": "*********\n* *     *\n*   *** *\n**^ * ***\n*   * ***\n* ***  E*\n*  *^S***\n**      *\n*********",
			"3,2": "*********\n* *     *\n*   *** *\n**^ * ***\n*   * ***\n* ***  E*\n*  *^ ***\n**S     *\n*********",
			"4,2": "*********\n* *     *\n*   *** *\n**^ * ***\n*   * ***\n* ***  E*\n*  *^ ***\n** S    *\n*********",
			"5,2": "*********\n* *     *\n*   *** *\n**^ * ***\n*   * ***\n* ***  E*\n*  *^ ***\n**  S   *\n*********",
			"6,2": "*********\n* *     *\n*   *** *\n**^ * ***\n*   * ***\n* ***  E*\n*  *^ ***\n**   S  *\n*********",
			"7,2": "*********\n* *     *\n*   *** *\n**^ * ***\n*   * ***\n* ***  E*\n*  *^ ***\n**    S *\n*********",
			"8,2": "*********\n* *     *\n*   *** *\n**^ * ***\n*   * ***\n* ***  E*\n*  *^ ***\n**     S*\n*********"
   },
   "walls":[
      
   ],
   "spikes":[
		 "3,6",
		 "5,3"
   ],
   "startPosition":{
      "x":"8",
      "y":"7"
   },
   "endPosition":{
      "x":"8",
      "y":"4"
   }
}	