{
"maps":{
  "og":"*********\n*S*****^*\n*     * *\n** ^^   ^\n*    ^* ^\n**** ** *\n*     ^^*\n*^ ^*****\n*E ******\n*********",
	"2,9":"*********\n*S*****^*\n*     * *\n** ^^   ^\n*    ^* ^\n**** ** *\n*     ^^*\n*^ ^*****\n*E ******\n*********",
	"2,8":"*********\n* *****^*\n*S    * *\n** ^^   ^\n*    ^* ^\n**** ** *\n*     ^^*\n*^ ^*****\n*E ******\n*********",
	"3,8":"*********\n* *****^*\n* S   * *\n** ^^   ^\n*    ^* ^\n**** ** *\n*     ^^*\n*^ ^*****\n*E ******\n*********",
	"4,8":"*********\n* *****^*\n*  S  * *\n** ^^   ^\n*    ^* ^\n**** ** *\n*     ^^*\n*^ ^*****\n*E ******\n*********",
	"5,8":"*********\n* *****^*\n*   S * *\n** ^^   ^\n*    ^* ^\n**** ** *\n*     ^^*\n*^ ^*****\n*E ******\n*********",
	"6,8":"*********\n* *****^*\n*    S* *\n** ^^   ^\n*    ^* ^\n**** ** *\n*     ^^*\n*^ ^*****\n*E ******\n*********",
	"8,8":"*********\n* *****^*\n*     *S*\n** ^^   ^\n*    ^* ^\n**** ** *\n*     ^^*\n*^ ^*****\n*E ******\n*********",
	"3,7":"*********\n* *****^*\n*     * *\n**S^^   ^\n*    ^* ^\n**** ** *\n*     ^^*\n*^ ^*****\n*E ******\n*********",
	"6,7":"*********\n* *****^*\n*     * *\n** ^^S  ^\n*    ^* ^\n**** ** *\n*     ^^*\n*^ ^*****\n*E ******\n*********",
	"7,7":"*********\n* *****^*\n*     * *\n** ^^ S ^\n*    ^* ^\n**** ** *\n*     ^^*\n*^ ^*****\n*E ******\n*********",
	"8,7":"*********\n* *****^*\n*     * *\n** ^^  S^\n*    ^* ^\n**** ** *\n*     ^^*\n*^ ^*****\n*E ******\n*********",
	"2,6":"*********\n* *****^*\n*     * *\n** ^^   ^\n*S   ^* ^\n**** ** *\n*     ^^*\n*^ ^*****\n*E ******\n*********",
	"3,6":"*********\n* *****^*\n*     * *\n** ^^   ^\n* S  ^* ^\n**** ** *\n*     ^^*\n*^ ^*****\n*E ******\n*********",
  "4,6":"*********\n* *****^*\n*     * *\n** ^^   ^\n*  S ^* ^\n**** ** *\n*     ^^*\n*^ ^*****\n*E ******\n*********",
	"5,6":"*********\n* *****^*\n*     * *\n** ^^   ^\n*   S^* ^\n**** ** *\n*     ^^*\n*^ ^*****\n*E ******\n*********",
	"8,6":"*********\n* *****^*\n*     * *\n** ^^   ^\n*    ^*S^\n**** ** *\n*     ^^*\n*^ ^*****\n*E ******\n*********",
	"5,5":"*********\n* *****^*\n*     * *\n** ^^   ^\n*    ^* ^\n****S** *\n*     ^^*\n*^ ^*****\n*E ******\n*********",
	"8,5":"*********\n* *****^*\n*     * *\n** ^^   ^\n*    ^* ^\n**** **S*\n*     ^^*\n*^ ^*****\n*E ******\n*********",
	"2,4":"*********\n* *****^*\n*     * *\n** ^^   ^\n*    ^* ^\n**** ** *\n*S    ^^*\n*^ ^*****\n*E ******\n*********",
	"3,4":"*********\n* *****^*\n*     * *\n** ^^   ^\n*    ^* ^\n**** ** *\n* S   ^^*\n*^ ^*****\n*E ******\n*********",
	"4,4":"*********\n* *****^*\n*     * *\n** ^^   ^\n*    ^* ^\n**** ** *\n*  S  ^^*\n*^ ^*****\n*E ******\n*********",
	"5,4":"*********\n* *****^*\n*     * *\n** ^^   ^\n*    ^* ^\n**** ** *\n*   S ^^*\n*^ ^*****\n*E ******\n*********",
	"6,4":"*********\n* *****^*\n*     * *\n** ^^   ^\n*    ^* ^\n**** ** *\n*    S^^*\n*^ ^*****\n*E ******\n*********",
	"3,3":"*********\n* *****^*\n*     * *\n** ^^   ^\n*    ^* ^\n**** ** *\n*     ^^*\n*^S^*****\n*E ******\n*********",
	"3,2":"*********\n* *****^*\n*     * *\n** ^^   ^\n*    ^* ^\n**** ** *\n*     ^^*\n*^ ^*****\n*ES******\n*********"
   },
   "walls":[
      
   ],
   "spikes":[
		 "2,3",
		 "4,3",
		 "7,4",
		 "8,4",
		 "6,6",
		 "9,6",
		 "4,7",
		 "5,7",
		 "9,7",
		 "8,9"
   ],
   "startPosition":{
      "x":"2",
      "y":"9"
   },
   "endPosition":{
      "x":"2",
      "y":"2"
   }
}	