{
"maps":{
  "og":"********\n*     ^*\n* ^^^ ^*\n* E^  ^*\n*^^  ^**\n*S  ^^**\n********",
	"2,2": "********\n*     ^*\n* ^^^ ^*\n* E^  ^*\n*^^  ^**\n*S  ^^**\n********",
	"3,2": "********\n*     ^*\n* ^^^ ^*\n* E^  ^*\n*^^  ^**\n* S ^^**\n********",
	"4,2": "********\n*     ^*\n* ^^^ ^*\n* E^  ^*\n*^^  ^**\n*  S^^**\n********",
	"4,3": "********\n*     ^*\n* ^^^ ^*\n* E^  ^*\n*^^S ^**\n*   ^^**\n********",
	"5,3": "********\n*     ^*\n* ^^^ ^*\n* E^  ^*\n*^^ S^**\n*   ^^**\n********",
	"2,4": "********\n*     ^*\n* ^^^ ^*\n*SE^  ^*\n*^^  ^**\n*   ^^**\n********",
	"5,4": "********\n*     ^*\n* ^^^ ^*\n* E^S ^*\n*^^  ^**\n*   ^^**\n********",
	"6,4": "********\n*     ^*\n* ^^^ ^*\n* E^ S^*\n*^^  ^**\n*   ^^**\n********",
	"6,5": "********\n*     ^*\n* ^^^S^*\n* E^  ^*\n*^^  ^**\n*   ^^**\n********",
	"2,5": "********\n*     ^*\n*S^^^ ^*\n* E^  ^*\n*^^  ^**\n*   ^^**\n********",
	"2,6": "********\n*S    ^*\n* ^^^ ^*\n* E^  ^*\n*^^  ^**\n*   ^^**\n********",
	"3,6": "********\n* S   ^*\n* ^^^ ^*\n* E^  ^*\n*^^  ^**\n*   ^^**\n********",
	"4,6": "********\n*  S  ^*\n* ^^^ ^*\n* E^  ^*\n*^^  ^**\n*   ^^**\n********",
	"5,6": "********\n*   S ^*\n* ^^^ ^*\n* E^  ^*\n*^^  ^**\n*   ^^**\n********",
	"6,6": "********\n*    S^*\n* ^^^ ^*\n* E^  ^*\n*^^  ^**\n*   ^^**\n********"

   },
   "walls":[
      
   ],
   "spikes":[
		 "2,3",
		 "3,3",
		 "6,3",
		 "5,2",
		 "6,2",
		 "4,4",
		 "7,4",
		 "3,5",
		 "4,5",
		 "5,5",
		 "7,5",
		 "7,6"
	 ],
   "startPosition":{
      "x":"2",
      "y":"2"
   },
   "endPosition":{
      "x":"3",
      "y":"4"
   }
}		