{
   "maps":{
      "og":"*******\n*  * S*\n** * **\n**   **\n**^ ^**\n*E    *\n*******",
			"6,6": "*******\n*  * S*\n** * **\n**   **\n**^ ^**\n*E    *\n*******",
			"5,6": "*******\n*  *S *\n** * **\n**   **\n**^ ^**\n*E    *\n*******",
			"2,6": "*******\n*S *  *\n** * **\n**   **\n**^ ^**\n*E    *\n*******",
			"3,6": "*******\n* S*  *\n** * **\n**   **\n**^ ^**\n*E    *\n*******",
			"3,5": "*******\n*  *  *\n**S* **\n**   **\n**^ ^**\n*E    *\n*******",
			"5,5": "*******\n*  *  *\n** *S**\n**   **\n**^ ^**\n*E    *\n*******",
			"3,4": "*******\n*  *  *\n** * **\n**S  **\n**^ ^**\n*E    *\n*******",
			"4,4": "*******\n*  *  *\n** * **\n** S **\n**^ ^**\n*E    *\n*******",
			"5,4": "*******\n*  *  *\n** * **\n**  S**\n**^ ^**\n*E    *\n*******",
			"4,3": "*******\n*  *  *\n** * **\n**   **\n**^S^**\n*E    *\n*******",
			"3,2": "*******\n*  *  *\n** * **\n**   **\n**^ ^**\n*ES   *\n*******",
			"4,2": "*******\n*  *  *\n** * **\n**   **\n**^ ^**\n*E S  *\n*******",
			"5,2": "*******\n*  *  *\n** * **\n**   **\n**^ ^**\n*E  S *\n*******",
			"6,2": "*******\n*  *  *\n** * **\n**   **\n**^ ^**\n*E   S*\n*******"
   },
   "walls":[
      
   ],
   "spikes":[
		 "3,3",
		 "5,3"
   ],
   "startPosition":{
      "x":"6",
      "y":"6"
   },
   "endPosition":{
      "x":"2",
      "y":"2"
   }
}	