{
   "maps":{
      "og":"********\n*S     *\n****** *\n*      *\n* ******\n*     E*\n********",
      "3,6":"********\n* S    *\n****** *\n*      *\n* ******\n*     E*\n********",
      "2,6":"********\n*S     *\n****** *\n*      *\n* ******\n*     E*\n********",
      "4,6":"********\n*  S   *\n****** *\n*      *\n* ******\n*     E*\n********",
			"5,6":"********\n*   S  *\n****** *\n*      *\n* ******\n*     E*\n********",
			"6,6":"********\n*    S *\n****** *\n*      *\n* ******\n*     E*\n********",
			"7,6":"********\n*     S*\n****** *\n*      *\n* ******\n*     E*\n********",
			"7,5":"********\n*      *\n******S*\n*      *\n* ******\n*     E*\n********",
			"7,4":"********\n*      *\n****** *\n*     S*\n* ******\n*     E*\n********",
			"6,4":"********\n*      *\n****** *\n*    S *\n* ******\n*     E*\n********",
			"5,4":"********\n*      *\n****** *\n*   S  *\n* ******\n*     E*\n********",
			"4,4":"********\n*      *\n****** *\n*  S   *\n* ******\n*     E*\n********",
			"3,4":"********\n*      *\n****** *\n* S    *\n* ******\n*     E*\n********",
      "2,4":"********\n*      *\n****** *\n*S     *\n* ******\n*     E*\n********",
			"2,3":"********\n*      *\n****** *\n*      *\n*S******\n*     E*\n********",
			"2,2":"********\n*      *\n****** *\n*      *\n* ******\n*S    E*\n********",
			"3,2":"********\n*      *\n****** *\n*      *\n* ******\n* S   E*\n********",
			"4,2":"********\n*      *\n****** *\n*      *\n* ******\n*  S  E*\n********",
			"5,2":"********\n*      *\n****** *\n*      *\n* ******\n*   S E*\n********",
			"6,2":"********\n*      *\n****** *\n*      *\n* ******\n*    SE*\n********"
   },
   "walls":[
      
   ],
   "spikes":[
      
   ],
   "startPosition":{
      "x":"2",
      "y":"6"
   },
   "endPosition":{
      "x":"7",
      "y":"2"
   }
}